************************************************
@.....*****.....**....*.**.**.................**
*.*.*....**.*.*....**.........*.***.**.**.*.****
*****.*********.**********.*.*********.........*
*...*....**........**.....*****........*******.*
*.****.*.**.****.*.****.*......******.**.*...*.*
*......****.*....****.************....*....*...*
******...*******...**.............***.**********
*......*.........*.**.*************............*
*********************....*.........*.*.*.*.*.*.*
*********************.*************.*.*.*.*.*..*
*........................*....................**
*.*.******************.*...**.*.*.*.*.*.*.*.*..*
*.*.********************************************
*.*.....**..............**********************&*
*.***.*.*..*.**********.*****.....***.....****.*
*.*.*.**..*..**....**...****..***..*..***..***.*
*.*...*..*..**..**.**.*......*****...*****..**.*
*.****..*..**..*.*.**.*.****..***..*..***..***.*
*.***..*..**..**.*.**.*.*****.....***.....****.*
*.**..*..**..*...*.**.*.**********************.*
*.*..*..**..**.***.**.*.**********************.*
*...***....*.......**..........................*
************************************************
