********
@.....**
*@*...&?
*.**&*.*
******?*
