**********
@.....****
*.*.*....*
*****.****
*...*....*
*.****.*.*
*......***
******...*
*......*.?
**********