**********
*.....**.?
*.*.*....*
*****.****
*........*
*.****.*.*
*.*....***
******...*
@......*.*
**********