********
@.....**
*.*....?
*.**.*.*
********
