*******
*.....*
*.***.*
@.*?..*
*.***.*
*.....*
*******