****************************
@...**********************.?
***.*****.....***.....****.*
*...****..***..*..***..***.*
*.*......*****...*****..**.*
*.*.****..***..*..***..***.*
*.*.*****.....***.....****.*
*.*.**********************.*
*.*.**********************.*
*..........................*
****************************