********
@@....**
*@*...&?
*.**&*.*
******?*
