****************************
@.*.**.**.................**
*.........*.***.**.*********
******.*.*********.........*
*.....*****........*******.*
***.*......******.**.*...*.*
*.*.**********....*....*...*
*.............***.**********					
*.*************............*
*..............*.*.*.*.*.*.*
*.*************.*.*.*.*.*..*
?....*....................**
**.*...**.*.*.*.*.*.*.*.*..*
****************************

