****************************
@......*...**.**...*....*..*
*.*.***..*..*.*..*..***..*.*
**..**..***.....***..***...*
**.**..***..*.*..***..***.**
*.....**...**?**...**......*
*.***..***..*.*..***..***.**
*..***..***.....***..***...*
**..***..*..*.*..*..***..*.*
***....*...**.**...*....*..*
****************************