********************
*..................@
*.*.****************
*.*.****************
*.*.....**.........?
*.***.*.*..*.*******
*.*.*.**..*..**....*
*.*...*..*..**..**.*
*.****..*..**..*.*.*
*.***..*..**..**.*.*
*.**..*..**..*...*.*
*.*..*..**..**.***.*
*...***....*.......*
********************