********
@@@@..**
*@*@.@&?
*@**&*.*
******?*
