************************************************
@.....*****.....**....*.**.**.................**
*.*.*....**.*.*....**.........*.***.**.*********
*****.*********.**********.*.*********.........*
*...*....**........**.....*****........*******.*
*.****.*.**.****.*.****.*......******.**.*...*.*
*......****.*....****.*.**********....*....*...*
******...*******...**.............***.**********
*......*.........*.**.*************............*
*********************..............*.*.*.*.*.*.*
*********************.*************.*.*.*.*.*..*
*........................*....................**
*.*.******************.*...**.*.*.*.*.*.*.*.*..*
*.*.********************************************
*.*.....**..............**********************.?
*.***.*.*..*.**********.*****.....***.....****.*
*.*.*.**..*..**....**...****..***..*..***..***.*
*.*...*..*..**..**.**.*......*****...*****..**.*
*.****..*..**..*.*.**.*.****..***..*..***..***.*
*.***..*..**..**.*.**.*.*****.....***.....****.*
*.**..*..**..*...*.**.*.**********************.*
*.*..*..**..**.***.**.*.**********************.*
*...***....*.......**..........................*
************************************************