********
@.&...**
*.*....*
*.**.*.*
********
